16 16
1 16
9
.,.......,....,.
,,....@@@,,,,,,,
......@@@....,..
.......#.....,..
.....,,,,,...,,,
.....,~~~,...,..
.....,~~~,...,..
.....,,,,,...,..
.......,.....,..
.......,.....,..
.......,,,,,,,..
.......,........
,,,,,,,,,,,,,,,,
................
,,............,,
.,............,.