16 16
.........,......
.........,,,,,..
.............,..
.............,..
.............,,,
......@@@....,..
......@@@....,..
.......#.....,..
.......,.....,..
.......,.....,..
.......,,,,,,,..
.......,........
,,,,,,,,,,,,,,,,
................
................
................