16 16
................
.......,,,,,,,,,
.......,........
.......,........
.......,........
.......,........
,,,,,,,,..@@@...
....,.....@@@...
....,.....@@@...
....,......#....
....,,,,,,,.....
..........,.....
..........,.....
..........,,,,..
.............,..
.............,..